"filename", "language", "TypeScript", "JSON", "comment", "blank", "total"
"c:\repos\MMO-Game\MMO-Game\sketch\Entity\Entity.ts", "TypeScript", -24, 0, 0, -3, -27
"c:\repos\MMO-Game\MMO-Game\sketch\Entity\Player.ts", "TypeScript", -139, 0, -6, -17, -162
"c:\repos\MMO-Game\MMO-Game\sketch\Game.ts", "TypeScript", -54, 0, 0, -9, -63
"c:\repos\MMO-Game\MMO-Game\sketch\Inventory\Inventory.ts", "TypeScript", -93, 0, -1, -13, -107
"c:\repos\MMO-Game\MMO-Game\sketch\Inventory\InventorySlot.ts", "TypeScript", -22, 0, 0, -2, -24
"c:\repos\MMO-Game\MMO-Game\sketch\Inventory\Item.ts", "TypeScript", -60, 0, 0, -7, -67
"c:\repos\MMO-Game\MMO-Game\sketch\Inventory\Items\Pickaxe.ts", "TypeScript", -10, 0, 0, -1, -11
"c:\repos\MMO-Game\MMO-Game\sketch\Inventory\Items\StoneItem.ts", "TypeScript", -5, 0, 0, -1, -6
"c:\repos\MMO-Game\MMO-Game\sketch\Menu\Buttons\StartButton.ts", "TypeScript", -17, 0, -1, -3, -21
"c:\repos\MMO-Game\MMO-Game\sketch\Menu\Buttons\WorldGenButton.ts", "TypeScript", -17, 0, -1, -3, -21
"c:\repos\MMO-Game\MMO-Game\sketch\Menu\Menu.ts", "TypeScript", -30, 0, 0, -3, -33
"c:\repos\MMO-Game\MMO-Game\sketch\Mining.ts", "TypeScript", -37, 0, -2, -3, -42
"c:\repos\MMO-Game\MMO-Game\sketch\sketch.ts", "TypeScript", -95, 0, 0, -10, -105
"c:\repos\MMO-Game\MMO-Game\sketch\utilities\Buttons.ts", "TypeScript", -62, 0, 0, -7, -69
"c:\repos\MMO-Game\MMO-Game\sketch\utilities\Constants.ts", "TypeScript", -16, 0, -1, -4, -21
"c:\repos\MMO-Game\MMO-Game\sketch\utilities\Utiles.ts", "TypeScript", -29, 0, -1, -4, -34
"c:\repos\MMO-Game\MMO-Game\sketch\world\Tile.ts", "TypeScript", -53, 0, -1, -14, -68
"c:\repos\MMO-Game\MMO-Game\sketch\world\Tiles\AirTile.ts", "TypeScript", -11, 0, 0, -3, -14
"c:\repos\MMO-Game\MMO-Game\sketch\world\Tiles\BedrockTile.ts", "TypeScript", -11, 0, 0, -2, -13
"c:\repos\MMO-Game\MMO-Game\sketch\world\Tiles\GrassTile.ts", "TypeScript", -11, 0, 0, -3, -14
"c:\repos\MMO-Game\MMO-Game\sketch\world\Tiles\StoneTile.ts", "TypeScript", -14, 0, 0, -4, -18
"c:\repos\MMO-Game\MMO-Game\sketch\world\World.ts", "TypeScript", -84, 0, 0, -7, -91
"c:\repos\MMO-Game\MMO-Game\sketch\world\WorldGen.ts", "TypeScript", -25, 0, -3, -5, -33
"c:\repos\MMO-Game\sketch\Game.ts", "TypeScript", 62, 0, 0, 11, 73
"c:\repos\MMO-Game\sketch\StartMenu\Buttons.ts", "TypeScript", 62, 0, 0, 8, 70
"c:\repos\MMO-Game\sketch\StartMenu\Buttons\StartButton.ts", "TypeScript", 17, 0, 0, 2, 19
"c:\repos\MMO-Game\sketch\StartMenu\Buttons\WorldGenButton.ts", "TypeScript", 17, 0, 0, 2, 19
"c:\repos\MMO-Game\sketch\StartMenu\StartMenu.ts", "TypeScript", 30, 0, 0, 3, 33
"c:\repos\MMO-Game\sketch\Test\Cheating.ts", "TypeScript", 25, 0, 1, 6, 32
"c:\repos\MMO-Game\sketch\data\crafting\recipes.json", "JSON", 0, 15, 0, 1, 16
"c:\repos\MMO-Game\sketch\game\Entity\Entity.ts", "TypeScript", 24, 0, 0, 3, 27
"c:\repos\MMO-Game\sketch\game\Entity\Player.ts", "TypeScript", 182, 0, 9, 23, 214
"c:\repos\MMO-Game\sketch\game\Entity\PlayerCharacter\BodyJoint.ts", "TypeScript", 0, 0, 10, 2, 12
"c:\repos\MMO-Game\sketch\game\Entity\PlayerCharacter\BodyPart.ts", "TypeScript", 0, 0, 3, 1, 4
"c:\repos\MMO-Game\sketch\game\Entity\PlayerCharacter\BodyPart\Body.ts", "TypeScript", 0, 0, 28, 5, 33
"c:\repos\MMO-Game\sketch\game\Entity\PlayerCharacter\BodyPart\Head.ts", "TypeScript", 0, 0, 6, 1, 7
"c:\repos\MMO-Game\sketch\game\Entity\PlayerCharacter\BodyPart\LeftArm.ts", "TypeScript", 0, 0, 6, 1, 7
"c:\repos\MMO-Game\sketch\game\Entity\PlayerCharacter\BodyPart\LeftLeg.ts", "TypeScript", 0, 0, 6, 1, 7
"c:\repos\MMO-Game\sketch\game\Entity\PlayerCharacter\BodyPart\RightArm.ts", "TypeScript", 0, 0, 5, 1, 6
"c:\repos\MMO-Game\sketch\game\Entity\PlayerCharacter\BodyPart\RightLeg.ts", "TypeScript", 0, 0, 6, 1, 7
"c:\repos\MMO-Game\sketch\game\Entity\PlayerCharacter\PlayerCharacterHandler.ts", "TypeScript", 0, 0, 25, 3, 28
"c:\repos\MMO-Game\sketch\game\GameMenu\Crafting\Crafting.ts", "TypeScript", 74, 0, 5, 8, 87
"c:\repos\MMO-Game\sketch\game\GameMenu\Crafting\CraftingButton.ts", "TypeScript", 16, 0, 0, 2, 18
"c:\repos\MMO-Game\sketch\game\GameMenu\Inventory\Inventory.ts", "TypeScript", 149, 0, 2, 21, 172
"c:\repos\MMO-Game\sketch\game\GameMenu\Inventory\InventorySlot.ts", "TypeScript", 35, 0, 3, 6, 44
"c:\repos\MMO-Game\sketch\game\GameMenu\Inventory\Item.ts", "TypeScript", 58, 0, 9, 12, 79
"c:\repos\MMO-Game\sketch\game\GameMenu\Inventory\ItemGen.ts", "TypeScript", 78, 0, 0, 6, 84
"c:\repos\MMO-Game\sketch\game\GameMenu\Inventory\Items\Abilities\Abilities.ts", "TypeScript", 7, 0, 0, 1, 8
"c:\repos\MMO-Game\sketch\game\GameMenu\Inventory\Items\Abilities\Mining.ts", "TypeScript", 41, 0, 1, 2, 44
"c:\repos\MMO-Game\sketch\game\GameMenu\Inventory\Items\Abilities\Teleport.ts", "TypeScript", 42, 0, 1, 10, 53
"c:\repos\MMO-Game\sketch\game\GameMenu\Inventory\Items\Stick.ts", "TypeScript", 1, 0, 0, 1, 2
"c:\repos\MMO-Game\sketch\game\GameMenu\Menu.ts", "TypeScript", 5, 0, 0, 1, 6
"c:\repos\MMO-Game\sketch\game\GameMenu\Skills\Skill.ts", "TypeScript", 33, 0, 0, 7, 40
"c:\repos\MMO-Game\sketch\game\GameMenu\Skills\SkillManager.ts", "TypeScript", 27, 0, 0, 3, 30
"c:\repos\MMO-Game\sketch\game\GameMenu\Skills\SkillMining.ts", "TypeScript", 7, 0, 0, 1, 8
"c:\repos\MMO-Game\sketch\game\GameMenu\Skills\lvlReq.ts", "TypeScript", 4, 0, 0, 2, 6
"c:\repos\MMO-Game\sketch\game\Mana\ManaManager.ts", "TypeScript", 31, 0, 0, 7, 38
"c:\repos\MMO-Game\sketch\game\utilities\Bar.ts", "TypeScript", 39, 0, 0, 5, 44
"c:\repos\MMO-Game\sketch\game\utilities\Constants.ts", "TypeScript", 45, 0, 0, 9, 54
"c:\repos\MMO-Game\sketch\game\utilities\Utiles.ts", "TypeScript", 74, 0, 1, 8, 83
"c:\repos\MMO-Game\sketch\game\utilities\Vec.ts", "TypeScript", 14, 0, 0, 3, 17
"c:\repos\MMO-Game\sketch\game\world\Tile.ts", "TypeScript", 81, 0, 1, 16, 98
"c:\repos\MMO-Game\sketch\game\world\TilesGen.ts", "TypeScript", 146, 0, 53, 10, 209
"c:\repos\MMO-Game\sketch\game\world\Tiles\AirTile.ts", "TypeScript", 0, 0, 14, 3, 17
"c:\repos\MMO-Game\sketch\game\world\Tiles\BedrockTile.ts", "TypeScript", 0, 0, 14, 2, 16
"c:\repos\MMO-Game\sketch\game\world\Tiles\GrassTile.ts", "TypeScript", 0, 0, 18, 4, 22
"c:\repos\MMO-Game\sketch\game\world\Tiles\StoneTile.ts", "TypeScript", 0, 0, 18, 5, 23
"c:\repos\MMO-Game\sketch\game\world\Tiles\TempTile.ts", "TypeScript", 0, 0, 8, 1, 9
"c:\repos\MMO-Game\sketch\game\world\World.ts", "TypeScript", 39, 0, 11, 8, 58
"c:\repos\MMO-Game\sketch\game\world\WorldGen.ts", "TypeScript", 62, 0, 26, 11, 99
"c:\repos\MMO-Game\sketch\sketch.ts", "TypeScript", 100, 0, 0, 8, 108
"Total", "-", 708, 15, 273, 130, 1126